id-000688_s-00_idx-0
id-000108_s-00_idx-0
id-001044_s-00_idx-0
id-001638_s-00_idx-0
id-001257_s-00_idx-0
id-002190_s-00_idx-0
id-000490_s-00_idx-0
id-002311_s-00_idx-0
id-001582_s-00_idx-0
id-002133_s-00_idx-0
id-000169_s-00_idx-0
id-001853_s-00_idx-0
id-000376_s-00_idx-0
id-001604_s-00_idx-0
id-000074_s-00_idx-0
id-002002_s-00_idx-0
id-000287_s-00_idx-0
id-001304_s-00_idx-0
id-002512_s-00_idx-0
id-002215_s-00_idx-0
id-002465_s-00_idx-0
id-001020_s-00_idx-0
id-001960_s-00_idx-0
id-000445_s-00_idx-0
id-000550_s-00_idx-0
id-000430_s-00_idx-0
id-001319_s-00_idx-0
id-000189_s-00_idx-0
id-001715_s-00_idx-0
id-002355_s-00_idx-0
id-000993_s-00_idx-0
id-000991_s-00_idx-0
id-002161_s-00_idx-0
id-001919_s-00_idx-0
id-000976_s-00_idx-0
id-000291_s-00_idx-0
id-001928_s-00_idx-0
id-002105_s-00_idx-0
id-001871_s-00_idx-0
id-000627_s-00_idx-0
id-001371_s-00_idx-0
id-000089_s-00_idx-0
id-001280_s-00_idx-0
