id-002107_s-00_idx-0
id-000376_s-00_idx-0
id-000030_s-00_idx-0
id-000238_s-00_idx-0
id-000904_s-00_idx-0
id-000733_s-00_idx-0
id-001460_s-00_idx-0
id-001774_s-00_idx-0
id-002025_s-00_idx-0
id-001329_s-00_idx-0
id-002194_s-00_idx-0
id-001231_s-00_idx-0
id-000649_s-00_idx-0
id-001445_s-00_idx-0
id-002005_s-00_idx-0
id-001873_s-00_idx-0
id-000987_s-00_idx-0
id-001525_s-00_idx-0
id-002400_s-00_idx-0
id-000871_s-00_idx-0
id-001695_s-00_idx-0
id-001928_s-00_idx-0
id-002577_s-00_idx-0
id-000164_s-00_idx-0
id-002061_s-00_idx-0
id-000115_s-00_idx-0
id-000570_s-00_idx-0
id-001095_s-00_idx-0
id-002550_s-00_idx-0
id-001487_s-00_idx-0
id-001666_s-00_idx-0
id-001053_s-00_idx-0
id-000596_s-00_idx-0
id-002081_s-00_idx-0
id-001148_s-00_idx-0
id-001907_s-00_idx-0
id-002223_s-00_idx-0
id-000118_s-00_idx-0
id-002236_s-00_idx-0
id-000689_s-00_idx-0
id-000387_s-00_idx-0
id-001226_s-00_idx-0
id-000920_s-00_idx-0
id-001881_s-00_idx-0
id-000634_s-00_idx-0
id-000670_s-00_idx-0
id-000856_s-00_idx-0
id-001804_s-00_idx-0
id-002289_s-00_idx-0
id-000764_s-00_idx-0
id-000368_s-00_idx-0
id-001346_s-00_idx-0
id-000783_s-00_idx-0
id-001731_s-00_idx-0
id-001491_s-00_idx-0
id-002213_s-00_idx-0
id-000699_s-00_idx-0
id-000524_s-00_idx-0
id-000760_s-00_idx-0
id-000816_s-00_idx-0
id-000630_s-00_idx-0
id-001733_s-00_idx-0
id-001728_s-00_idx-0
id-000219_s-00_idx-0
id-001264_s-00_idx-0
