ISIC_0012169
ISIC_0012418
ISIC_0012472
ISIC_0012607
ISIC_0012650
ISIC_0012925
ISIC_0012948
ISIC_0014967
ISIC_0015448
ISIC_0015450
ISIC_0015451
ISIC_0015478
ISIC_0015633
ISIC_0015977
ISIC_0016020
ISIC_0016021
ISIC_0016047
ISIC_0019090
ISIC_0019178
ISIC_0020135
ISIC_0020226
ISIC_0020563
ISIC_0020987
ISIC_0021035
ISIC_0021036
ISIC_0021121
ISIC_0021147
ISIC_0021195
ISIC_0021278
ISIC_0021313
ISIC_0021319
ISIC_0021506
ISIC_0021551
ISIC_0021558
ISIC_0021559
ISIC_0021583
ISIC_0021615
ISIC_0021701
ISIC_0021711
ISIC_0021796
ISIC_0021826
ISIC_0021832
ISIC_0021833
ISIC_0021873
ISIC_0021902
ISIC_0021936
ISIC_0021956
ISIC_0021973
ISIC_0022006
ISIC_0022007
ISIC_0022009
ISIC_0022015
ISIC_0022313
ISIC_0022342
ISIC_0022395
ISIC_0022436
ISIC_0022444
ISIC_0022457
ISIC_0022550
ISIC_0022552
ISIC_0022663
ISIC_0022678
ISIC_0022735
ISIC_0022742
ISIC_0022820
ISIC_0022928
ISIC_0023158
ISIC_0023199
ISIC_0023257
ISIC_0023258
ISIC_0023261
ISIC_0023269
ISIC_0023283
ISIC_0023300
ISIC_0023306
ISIC_0023358
ISIC_0023366
ISIC_0023396
ISIC_0023482
ISIC_0023483
ISIC_0023506
ISIC_0023696
ISIC_0023721
ISIC_0023765
ISIC_0024054
ISIC_0024188
ISIC_0024191
ISIC_0036067
ISIC_0036075
ISIC_0036078
ISIC_0036081
ISIC_0036086
ISIC_0036095
ISIC_0036099
ISIC_0036107
ISIC_0036108
ISIC_0036137
ISIC_0036154
ISIC_0036162
ISIC_0036170
ISIC_0036172
ISIC_0036180
ISIC_0036189
ISIC_0036190
ISIC_0036198
ISIC_0036207
ISIC_0036209
ISIC_0036211
ISIC_0036214
ISIC_0036230
ISIC_0036232
ISIC_0036235
ISIC_0036243
ISIC_0036248
ISIC_0036255
ISIC_0036257
ISIC_0036261
ISIC_0036269
ISIC_0036270
ISIC_0036329
id-000000_s-00_idx-0
id-000000_s-01_idx-0
id-000001_s-00_idx-0
id-000001_s-01_idx-0
id-000002_s-00_idx-0
id-000002_s-01_idx-0
id-000003_s-00_idx-0
id-000003_s-01_idx-0
id-000004_s-00_idx-0
id-000004_s-01_idx-0
id-000005_s-00_idx-0
id-000005_s-01_idx-0
id-000006_s-00_idx-0
id-000006_s-01_idx-0
id-000007_s-00_idx-0
id-000007_s-01_idx-0
id-000008_s-00_idx-0
id-000008_s-01_idx-0
id-000009_s-00_idx-0
id-000009_s-01_idx-0
id-000010_s-00_idx-0
id-000010_s-01_idx-0
id-000011_s-00_idx-0
id-000011_s-01_idx-0
id-000012_s-00_idx-0
id-000012_s-01_idx-0
id-000013_s-00_idx-0
id-000013_s-01_idx-0
id-000014_s-00_idx-0
id-000014_s-01_idx-0
id-000015_s-00_idx-0
id-000015_s-01_idx-0
id-000016_s-00_idx-0
id-000016_s-01_idx-0
id-000017_s-00_idx-0
id-000017_s-01_idx-0
id-000018_s-00_idx-0
id-000018_s-01_idx-0
id-000019_s-00_idx-0
id-000019_s-01_idx-0
id-000020_s-00_idx-0
id-000020_s-01_idx-0
id-000021_s-00_idx-0
id-000021_s-01_idx-0
id-000022_s-00_idx-0
id-000022_s-01_idx-0
id-000023_s-00_idx-0
id-000023_s-01_idx-0
id-000024_s-00_idx-0
id-000024_s-01_idx-0
id-000025_s-00_idx-0
id-000025_s-01_idx-0
id-000026_s-00_idx-0
id-000026_s-01_idx-0
id-000027_s-00_idx-0
id-000027_s-01_idx-0
id-000028_s-00_idx-0
id-000028_s-01_idx-0
id-000029_s-00_idx-0
id-000029_s-01_idx-0
id-000030_s-00_idx-0
id-000030_s-01_idx-0
id-000031_s-00_idx-0
id-000031_s-01_idx-0
id-000032_s-00_idx-0
id-000032_s-01_idx-0
id-000033_s-00_idx-0
id-000033_s-01_idx-0
id-000034_s-00_idx-0
id-000034_s-01_idx-0
id-000035_s-00_idx-0
id-000035_s-01_idx-0
id-000036_s-00_idx-0
id-000036_s-01_idx-0
id-000037_s-00_idx-0
id-000037_s-01_idx-0
id-000038_s-00_idx-0
id-000038_s-01_idx-0
id-000039_s-00_idx-0
id-000039_s-01_idx-0
id-000040_s-00_idx-0
id-000040_s-01_idx-0
id-000041_s-00_idx-0
id-000041_s-01_idx-0
id-000042_s-00_idx-0
id-000042_s-01_idx-0
id-000043_s-00_idx-0
id-000043_s-01_idx-0
id-000044_s-00_idx-0
id-000044_s-01_idx-0
id-000045_s-00_idx-0
id-000045_s-01_idx-0
id-000046_s-00_idx-0
id-000046_s-01_idx-0
id-000047_s-00_idx-0
id-000047_s-01_idx-0
id-000048_s-00_idx-0
id-000048_s-01_idx-0
id-000049_s-00_idx-0
id-000049_s-01_idx-0
id-000050_s-00_idx-0
id-000050_s-01_idx-0
id-000051_s-00_idx-0
id-000051_s-01_idx-0
id-000052_s-00_idx-0
id-000052_s-01_idx-0
id-000053_s-00_idx-0
id-000053_s-01_idx-0
id-000054_s-00_idx-0
id-000054_s-01_idx-0
id-000055_s-00_idx-0
id-000055_s-01_idx-0
id-000056_s-00_idx-0
id-000056_s-01_idx-0
id-000057_s-00_idx-0
id-000057_s-01_idx-0
id-000058_s-00_idx-0
id-000058_s-01_idx-0
id-000059_s-00_idx-0
id-000059_s-01_idx-0
id-000060_s-00_idx-0
id-000060_s-01_idx-0
id-000061_s-00_idx-0
id-000061_s-01_idx-0
id-000062_s-00_idx-0
id-000062_s-01_idx-0
id-000063_s-00_idx-0
id-000063_s-01_idx-0
id-000064_s-00_idx-0
id-000064_s-01_idx-0
id-000065_s-00_idx-0
id-000065_s-01_idx-0
id-000066_s-00_idx-0
id-000066_s-01_idx-0
id-000067_s-00_idx-0
id-000067_s-01_idx-0
id-000068_s-00_idx-0
id-000068_s-01_idx-0
id-000069_s-00_idx-0
id-000069_s-01_idx-0
id-000070_s-00_idx-0
id-000070_s-01_idx-0
id-000071_s-00_idx-0
id-000071_s-01_idx-0
id-000072_s-00_idx-0
id-000072_s-01_idx-0
id-000073_s-00_idx-0
id-000073_s-01_idx-0
id-000074_s-00_idx-0
id-000074_s-01_idx-0
id-000075_s-00_idx-0
id-000075_s-01_idx-0
id-000076_s-00_idx-0
id-000076_s-01_idx-0
id-000077_s-00_idx-0
id-000077_s-01_idx-0
id-000078_s-00_idx-0
id-000078_s-01_idx-0
id-000079_s-00_idx-0
id-000079_s-01_idx-0
id-000080_s-00_idx-0
id-000080_s-01_idx-0
id-000081_s-00_idx-0
id-000081_s-01_idx-0
id-000082_s-00_idx-0
id-000082_s-01_idx-0
id-000083_s-00_idx-0
id-000083_s-01_idx-0
id-000084_s-00_idx-0
id-000084_s-01_idx-0
id-000085_s-00_idx-0
id-000085_s-01_idx-0
id-000086_s-00_idx-0
id-000086_s-01_idx-0
id-000087_s-00_idx-0
id-000087_s-01_idx-0
id-000088_s-00_idx-0
id-000088_s-01_idx-0
id-000089_s-00_idx-0
id-000089_s-01_idx-0
id-000090_s-00_idx-0
id-000090_s-01_idx-0
id-000091_s-00_idx-0
id-000091_s-01_idx-0
id-000092_s-00_idx-0
id-000092_s-01_idx-0
id-000093_s-00_idx-0
id-000093_s-01_idx-0
id-000094_s-00_idx-0
id-000094_s-01_idx-0
id-000095_s-00_idx-0
id-000095_s-01_idx-0
id-000096_s-00_idx-0
id-000096_s-01_idx-0
id-000097_s-00_idx-0
id-000097_s-01_idx-0
id-000098_s-00_idx-0
id-000098_s-01_idx-0
id-000099_s-00_idx-0
id-000099_s-01_idx-0
id-000100_s-00_idx-0
id-000100_s-01_idx-0
id-000101_s-00_idx-0
id-000101_s-01_idx-0
id-000102_s-00_idx-0
id-000102_s-01_idx-0
id-000103_s-00_idx-0
id-000103_s-01_idx-0
id-000104_s-00_idx-0
id-000104_s-01_idx-0
id-000105_s-00_idx-0
id-000105_s-01_idx-0
id-000106_s-00_idx-0
id-000106_s-01_idx-0
id-000107_s-00_idx-0
id-000107_s-01_idx-0
id-000108_s-00_idx-0
id-000108_s-01_idx-0
id-000109_s-00_idx-0
id-000109_s-01_idx-0
id-000110_s-00_idx-0
id-000110_s-01_idx-0
id-000111_s-00_idx-0
id-000111_s-01_idx-0
id-000112_s-00_idx-0
id-000112_s-01_idx-0
id-000113_s-00_idx-0
id-000113_s-01_idx-0
id-000114_s-00_idx-0
id-000114_s-01_idx-0
id-000115_s-00_idx-0
id-000115_s-01_idx-0
id-000116_s-00_idx-0
id-000116_s-01_idx-0
id-000117_s-00_idx-0
id-000117_s-01_idx-0
id-000118_s-00_idx-0
id-000118_s-01_idx-0
id-000119_s-00_idx-0
id-000119_s-01_idx-0
id-000120_s-00_idx-0
id-000120_s-01_idx-0
id-000121_s-00_idx-0
id-000121_s-01_idx-0
id-000122_s-00_idx-0
id-000122_s-01_idx-0
id-000123_s-00_idx-0
id-000123_s-01_idx-0
id-000124_s-00_idx-0
id-000124_s-01_idx-0
id-000125_s-00_idx-0
id-000125_s-01_idx-0
id-000126_s-00_idx-0
id-000126_s-01_idx-0
id-000127_s-00_idx-0
id-000127_s-01_idx-0
id-000128_s-00_idx-0
id-000128_s-01_idx-0
